111111111111111111111111111111111111111111111111111111111111
100000000000000000000000000000000000000000000000000000000E11
10000000000000000000000000CCCCCCCCCCCCCCCC000000000000000011
1CCCCCCCCCCCCCCCCC00000000000000000000000000CCCCCCCCCCCC0011
100000000000000000000000011111111111111111110000000000000011
10000CCCCCCCCCCCCCCCCCCCC11111111111111111111111111111111111
10000CCCCCCCCCCCCCCCCCCCCCCCCCCCCCCCCCCCCCC00000000000000011
100000000000000000000000000000000000000000000000011111111111
1P0000000000000000000CCCCCCCCCCCCCCCCCCC11111111111111111111
111111111111111111111111111111111111111111111111111111111111