1111111
10CP111
1110111
10C01E1
1111111