1111111
10CP011
10C01E1
1111111