1111111
1C1P111
10C01E1
1111111