1111111
10P1111
111011E
10C0111
1111111