1111111
10C1111
10P01E1
1111111