1111111
10C1P01
101111E
1111111