1111111
10C0P01
10C011E
1111111