1111111111111111111111111
1000000000100000000010001
100000000E100000001C10001
1000000000C00000P00000001
1111111111111111111111111