1111111111111
1C00P00C000E1
1111111111111