11111111111111111111111
10000000000000000000001
10000000E0000C000000001
100000000000P0000000C01
11111111111111111111111