1111111111111111111
1CC0CCCCCCCCCCCCC01
1C111111C1C111111C1
1C1CCCCCC1CCCCCCEC1
1CCC1C11CCC1101CCC1
11111C1111111011111
10CCCC1111111000001
1011111111111111111
1CCCCCC0C0CCCCCCCC1
1C11111100C111111C1
1C1CCCCCC1CCCCCC1C1
1CCC1C11CCC1101CCC1
11111C1111111011111
1PCCCC1111111000001
1011111111111111111
1CCCCCCCCCCCCCCCCC1
1C111111C1C111111C1
1C1CCCC0C1CCCCCC1C1
1CCC1C11CHC1101CCC1
11111C1111111011111
10CCCC1111111000C11
1111111111111111111