11111111111111111111111111
1P111111111111111111111E11
10111111111111111111111011
10000000000001000010100011
11011101110101011110101011
11000100010001000000101011
11110101100011011010001011
10000100010000000010100011
10111111111111111111111011
1C111111111111111111111C11
11111111111111111111111111