111111111111111111111111111111111111111111111111111111111111
1E0000100010000010000000100000000011000100000000000000000001
110010101010111C10111011101110111011110100000000000000000001
10001000101C101010001000001010100000000100000000000000000001
101011101111101011111110101011101111110100000000000000000001
10101010000C00000010C000101000101001000100000000000000000001
111110110111011110101111101011111111010100000000000000000001
101C10110110000010100000100C00101000010100000000000000000001
101010101011101110111010110111101111110100000000000000000001
100000101010000010000010101000100010000100000000000000000001
101010101111111011101111101011111011110100000000000000000001
10101000C00010000010000C00000010000P01C100000000000000000001
10101010000C00000010C000101000101001000100000000000000000001
111110111111011110101111101011111111010100000000000000000001
101C10100010000010100000100C00101000010100000000000000000001
101010101011101110111010111111101111110100000000000000000001
100000101010000010000H10101000100010000100000000000000000001
101010101111111011101101101011111011110100000000000000000001
10101000C00010000010000C00000010000001C100000000000000000001
101010101111101110101010111011101111110000000000000000000001
1C1010100000001000001010001000001000000100000000000000000001
1C1010100000001000001010001000001000000100000000000000000001
1C1010111110001000001010001001111100000100000000000000000001
1C1010100000001001101010001000001001110100000000000000000001
1C1010100111110000010100011111001000000100000000000000000001
1C1010100000001000001010001000001000000100000000000000000001
1C1010100011111000001010001000001011100100000000000000000001
1C1010100000001000001010001011110100000100000000000000000001
1C1010111110010011010100010000010000000100000000000000000001
1C1010100000001000001010001000001000000100000000000000000001
111111111111111111111111111111111111111111111111111111111111