111111111111111111111111111111111111111111111111111111111111
100000000000000000000000000000000000000000000000000000000001
1000010000CCCCC100000000010000000000001111111111111110000001
1000010H0000000100000000101000000000001CCCCCCCCCCCCCC0000001
1000010000P0000100000001000100000000001CCCCCCCCCCCCCC0000001
1000010E0000C0010000C010000010000000001CCCCCCCCCCCCCC0000001
100001111111111100000100000001000000001CCCCCCCCCCCCCC0000001
100000000010000000001111111111100000001111111111111110000001
1000000000100000000C000000000001000000CCCCCCCCCCCCCC10000001
1000000000100000C001000000000000100000CCCCCCCCCCCCCC10000001
10000000001000000001CCCCCCCCCCCC100000CCCCCCCCCCCCCC10000001
10000000001000000001CCCCCCCCCCCC100000CCCCCCCCCCCCCC10000001
10000000001000000001CCCCCCCCCCCC100000CCCCCCCCCCCCCC10000001
10000000001000000001CCCCCCCCCCCC100000CCCCCCCCCCCCCC10000001
10000000001000000001CCCCCCCCCCCC1000000111111111111110000001
111111111111111111111111111111111111111111111111111111111111